--- Set 1 ---
Steppenwolf - Born to be Wild
Tommy Tutone - Jenny 867-5309
Waiting for Walter - My Pillow
Alanis Morissette - You Oughta Know
Eve 6 - Inside Out
Tom Petty - American Girl
The Romantics - What I Like About You
Green Day - Basket Case
Michael Jackson - Billie Jean
Alanis Morissette - Hand in my Pocket
Wheatus - Teenaged Dirtbag
The Georgia Satellites - Keep Your Hands To Yourself
Katrina and the Waves - Walkin on Sunshine
Weezer - Beverly Hills
Brooks and Dunn - Boot Scootin Boogie
Elle King - Ex's & Oh's
Jimmy Eat World - The Middle
Lynyrd Skynyrd - Gimmee Three Steps
The Doors - Roadhouse Blues
Fountains of Wayne - Stacys Mom
Chuck Berry - Johnny B Goode
KT Tunstall - Black Horse and a Cherry Tree
Lit - My Own Worst Enemy
Van Morrison - Brown Eyed Girl
Darius Rucker - Wagon Wheel
Nirvana - Smells Like Teen Spirit
Tom Petty and the Heartbreakers - Last Dance with
No Doubt - Just A Girl
Radiohead - Creep
The Beatles - Saw Her Standing There
4 Non Blondes - What's Up
Blink 182 - All the Small Things
Billy Joel - You May Be Right
Joan Jett - Bad Reputation
Bryan Adams - Summer of '69
Eric Church - Drink in my Hand
Joan Jett - I Love Rock n Roll
The Rolling Stones - Honkey Tonk Women
Johnny Cash - Folsom Prison Blues
Gretchen Wilson - Here For the Party
John Mellencamp - Wild Night
The Chicks - Goodbye Earl
Wilson Pickett - Mustang Sally
Third Eye Blind - Semi Charmed Life
The Beatles - Twist and Shout
Pink - Raise Your Glass
The Rolling Stones - Its All Over Now
Led Zeppelin - Rock and Roll
Wild Cherry - Play the Funky Music
Stevie Wonder - Superstitious
Red Hot Chili Peppers - Higher Ground
Mudcrutch - Six Days on the Road