--- Set 1 ---
Steppenwolf - Born to be Wild
Grand Funk Railroad - We're an American Band
Joan Jett - Bad Reputation
Robert Palmer - Bad Case of Loving You
Tom Petty and the Heartbreakers - Last Dance with
Dwight Yoakam- Fast As You
Queen - Crazy Little Thing Called Love
Tommy Tutone - Jenny 867-5309
4 Non Blondes - What's Up
Meredith Brooks - Bitch
The Chicks - Goodbye Earl
Amy Winehouse - Valerie
The Doors - Roadhouse Blues
Third Eye Blind - Semi Charmed Life
Wheatus - Teenaged Dirtbag
Eve 6 - Inside Out
--- Set 2 ---
Weezer - Beverly Hills
Elle King - Ex's & Oh's
Bowling for Soup - 1985
Fountains of Wayne - Stacys Mom
Violent Femmes - Blister In The Sun
Alanis Morissette - You Oughta Know
Bryan Adams - Summer of '69
The Rolling Stones - Honkey Tonk Women
Lynyrd Skynyrd - Gimmee Three Steps
Elvis Presley - Burning Love
Chris Stapleton - Tennessee Whiskey
Nitty Gritty Dirt Band - Fishin in the Dark
Maneskin - Beggin
Pink - Raise Your Glass
The Romantics - What I Like About You
Jimmy Eat World - The Middle
Guns N' Roses - Sweet Child O Mine
--- Set 3 ---
The Pretty Reckless - Take Me Down
The Cranberries - Zombie
Blink 182 - All the Small Things
Pat Benatar - Heartbreaker
Rick Springfield - Jessies Girl
Lit - My Own Worst Enemy
Finger Eleven - Paralyzer
Darius Rucker - Wagon Wheel
No Doubt - Just A Girl
Neon Trees - Everybody Talks
Green Day - Basket Case
Black Crowes - Hard to Handle
Radiohead - Creep
Garth Brooks - Friends in Low Places
--- Extras ---
Mudcrutch - Six Days on the Road
Lita Ford - Kiss Me Deadly
The Allman Brothers Band - One Way Out
Beastie Boys - Fight for Your Right
The Go-Go's - We Got the Beat
Metallica - Enter Sandman
Kid Rock - All Summer Long
Tracy Chapman - Give Me One Reason
Little Big Town - Pontoon
Eric Church - Drink in my Hand
Bob Seger - Old Time RNR
Wilson Pickett - Mustang Sally
The Georgia Satellites - Keep Your Hands To Yourself
Katrina and the Waves - Walkin on Sunshine
Shocking Blue - Venus
Johnny Cash - Folsom Prison Blues